XXXXXXXXXXXXXXXXXXXXXXXXXXXXXXXXXXXXXXXXXXXXXXXXXXXXXXXXXXXXXXXXXXXXXXXXXXXXXXXXXXXXXXX
X                                                  X             #          X    #    X
X           XXXXXXXXXXXXXXXXXXXXXXXXXXXXXXX        X                        X   # #   X
X                                         X                                 X         X
X                                         X                                 XXXXXXXX  X
X                                         XXXXXXXXXXXXXXXXXXX                         X
X           XXXXXXXXX                                       X                         X
X           X     # X                                       XXXXXXXXXXXXXXXXXXXXXXXXXXX
X                   X                                                                 X
X           XXXXXXXXX                                                                 X
X                                                                                     X
X                                                                                     X
X                                                                                     X
X                  XXXXXXXXXX  XXXXXXXXXXXXXXXXXXXX                                   X
X                  X                              X            XXXXXXXX  XXXXXXX      X
X                  X                              X            X               X      X
X                  X                              X            X               X      X
X                  XXXXXXXXXX        X            X            XXXX         XXXX      X
XXXXXXXX                    X        X            X               X         X         X
X         X                 X        X            X               X         X     #   X
X # #     X                 X      # X  #         X               X    #    X         X
XXXXXXXXXXXXXXXXXXXXXXXXXXXXXXXXXXXXXXXXXXXXXXXXXXXXXXXXXXXXXXXXXXXXXXXXXXXXXXXXXXXXXXX
