XXXXXXXXXXXXXXXXXXXXXXXXXXXXXXXXXXXXXXXXXXXXXXXXXXXXXXXXXXXXXXXXXXXXXXXXXXXXXXXXXXXXXXX
X                          %                       X             #          X    #    X
X           XXXXXXXXXXXXXXXXXXXXXXXXXXXXXXX        X                        X   # #   X
X                                         X                                 X        %X
X                                         X                     %           XXXXXXXXX X
X                                         XXXXXXXXXXXXXXXXXXX                         X
X           XXXXXXXXX                                       X                         X
X           X     # X                                       XXXXXXXXXXXXXXXXXXXXXXXXXXX
X            %      X                                                                 X
X           XXXXXXXXX                       @                                         X
X                                                                                     X
X                                                                                     X
X      %                                                                              X
X                  XXXXXXXXXX XXXXXXXXXXXXXXXXXXXXX                                   X
X                  X         %                    X            XXXXXXXX XXXXXXXX      X
X                  X                              X            X       %       X      X
X                  X                              X            X       %       X      X
X                  XXXXXXXXXX        X            X            XXXX         XXXX      X
XXXXXXXXX                   X        X            X               X         X         X
X        %X                 X        X            X               X         X     #   X
X # #     X                 X      # X  #         X               X    #    X         X
XXXXXXXXXXXXXXXXXXXXXXXXXXXXXXXXXXXXXXXXXXXXXXXXXXXXXXXXXXXXXXXXXXXXXXXXXXXXXXXXXXXXXXX
