XXXXXXXXXXXXXXXXXXXXXXXXXXXXXXXXXXXXXXXXXXXXXXXXXXXXXXXXXXXXXXXXXXXXXXXXXXXXXXXXXXXXXXX
X                                                  X                                  X
X           XXXXXXXXXXXXXXXXXXXXXXXXXXXXXXX        X                                  X
X                      X                  X        X                     # # # #      X
X     #                X                  X   #    X        %%     %                  X
X         XXXXX        X                  XXXXXXXXXXXXXXXXX % %                       X
X          % #X        X                                   %X %                       X
X         XXXXX        X                X         X      %  XXXXXXXXXXXXXXXXXXXXXXXXXXX
X                      X                X         X     %        X   #    X   #  X #  X
X                      X                X  XXXX   X              X                    X
X                      X                X   #     X              X XXXXXXXXXXXXXXXXXXXX
X   XXXXXXXXXX                          X  XXXX   X              X                 %  X
X                                       X   #     X              XXXXXXXXXXXXXXXXXXXX X
X    #             XXXXXXXXXXXXXXXXXXXXXXXXXXXXXXXX                       X#         %X
X                                                 X                       X           X
X              XXXXXXXXXX                         X                       XXXXXXXXXXX X
X       #                            XXXXXXXXXXXX X             @         X     #     X
X                                    X            X       #               X XXXXXXXXXXX
X         #                 X        X            X                       X  %        X
X                           X        X            X                       XXXXXXXXXXX X
X           #               X    ### X  #####     X                          %  #     X
XXXXXXXXXXXXXXXXXXXXXXXXXXXXXXXXXXXXXXXXXXXXXXXXXXXXXXXXXXXXXXXXXXXXXXXXXXXXXXXXXXXXXXX
